0,  1,  2,  3,  4,  5,  6,  7,  8,  9,  10,  11,  12,  13,  14,  15,  16,  17,  18,  19,
20,  22,  24,  26,  28,  30,  32,  34,  36,  38,  40,  42,  44,  46,  48,  50,  53,
56,  59,  62,  65,  69,  73,  78,  83,  88,  93,  98,  103,  109,  115,  121,  127,
133,  141,  149,  157,  164,  171,  178,  186,  196,  206,  216,  226,  235,  247,
259,  270,  284,  298,  305,  319,  333,  347,  361,  375,  389,  417,  445,  473,
487,  515,  542,  569,  569,  596,  623,  650,  676,  711,  763,  792,  792,  843,
868,  918,  971,  1024,  1071,  1118,  1176,  1267,  1355,  1440,  1522,  1623,
1730,  1849,  1974,  2116,  2298,  2468,  2651,  2813,  3017,  3258,  3449,
3638,  3894,  4095,  
